cell.names	copykat.pred
CCATAAGGTGGAAATT-1	aneuploid
TAACGACCATGCGGTC-1	diploid
TGTAGACTCCCATTCG-1	aneuploid
GCGAGAACATCCGTTC-1	aneuploid
CGCATAATCGCCCAGA-1	aneuploid
TAACACGCACTATGTG-1	aneuploid
TATTTCGCAGCATTGT-1	aneuploid
GGAGGATAGCTAGCCC-1	diploid
CTAGACAAGCGCCGTT-1	diploid
TTACCGCTCCAACCAA-1	aneuploid
GTGTAACCAAGGTTGG-1	diploid
TCAGCCTAGTAACGTA-1	aneuploid
CAGTTCCCATGGAGAC-1	aneuploid
TTTCATGGTCTCGACG-1	aneuploid
CAATCGAAGCGACAGT-1	aneuploid
TTCAATCGTAATCAAG-1	diploid
TGCATCCCATTAAGCC-1	aneuploid
TCTCTGGCAATATCCG-1	aneuploid
GAGCCTGTCACTGGTA-1	aneuploid
TCGGATAGTTTGGGTT-1	aneuploid
AGGGTCCCAACGGTAG-1	aneuploid
GAAGAATTCTTTCAGT-1	aneuploid
CAGCAATGTAGATCGG-1	diploid
ACATGCAGTACAATAG-1	diploid
GTTGTAGTCGACTCCT-1	aneuploid
GGAGCAAGTGTAACGG-1	diploid
TATCCTAAGATCCCGC-1	diploid
TTCCTTCTCTTCCCGA-1	diploid
TACCTCGGTATGTCCA-1	aneuploid
GTAACACAGTAAGACT-1	aneuploid
ATGCGATCATTGCAAC-1	diploid
AGTGCCGCATTATGCG-1	diploid
TCGTGGGCAGTACTAC-1	diploid
TGTAACGCACTGAATC-1	diploid
TTCGATTAGCACACCC-1	aneuploid
TCAGCAATCGCATGAT-1	diploid
CTGCATCTCATCCTAT-1	diploid
TCCATCGTCATTCTTG-1	aneuploid
CCTCCAATCTACGCGG-1	aneuploid
CCGGGTATCGTGCGAC-1	aneuploid
ATGTCCCGTGCATACT-1	diploid
AGTAGTCGTCGTGTTA-1	aneuploid
CTCAATTTCACGGTCG-1	aneuploid
CCTCAGTCAAATGGTA-1	diploid
AATCACGGTATGCAAA-1	aneuploid
GACGTTAGTTGGCTAT-1	diploid
GAAGCGATCTGAGGCC-1	aneuploid
GTTGTAGCAATCAGCT-1	aneuploid
GATCGTAAGGGAGGGT-1	aneuploid
AGGTCTAGTAAGTCAA-1	aneuploid
ACAGGGACATGTCTAG-1	aneuploid
TTCACCGTCAGTGTCA-1	aneuploid
TGGGAAGCATGAGTAA-1	aneuploid
AACCCAACACCAGTAT-1	aneuploid
CTCCAACTCTAGGAAA-1	aneuploid
AGAAGTAAGAGCATAT-1	aneuploid
AGCGCTGAGCAGCCTC-1	aneuploid
TAGACTGCAGAGACTG-1	aneuploid
AACGGGATCGTTCTCG-1	aneuploid
GTTCGCTAGGTAAGTT-1	diploid
GTCACGGCATCGCTGG-1	aneuploid
ACACAGTCAAACAGGC-1	diploid
ATTACTCAGGTGCGAT-1	aneuploid
ATGGATCCACCTGTCT-1	diploid
GTTCGCTCAACCCTCT-1	aneuploid
AAAGTGACAGATCCTA-1	aneuploid
CAAAGAAGTTTCTATC-1	aneuploid
AGCGCTGGTGTGAATA-1	aneuploid
AGAAGTATCGACGTCG-1	diploid
TAGCACATCCTTCTGG-1	diploid
ATGTCCCCATTGGGAG-1	aneuploid
AAACCCACAGGTATGG-1	aneuploid
TTGATGGAGTAGACCG-1	aneuploid
AGACCATGTGCGAGTA-1	aneuploid
AGGATCTGTCGTGATT-1	aneuploid
CGAGGCTTCCATAGGT-1	aneuploid
CAGATACGTGAAGCGT-1	aneuploid
TGGTGATAGGACAAGA-1	diploid
ATGCCTCGTCTCAAGT-1	diploid
CGCATGGCACAGCGCT-1	diploid
AGAGCCCAGCCATATC-1	aneuploid
CATCCACTCACAAGAA-1	diploid
CTATAGGCAGCAAGAC-1	aneuploid
GCTGCAGGTCGTGGTC-1	aneuploid
CCGGTAGTCACGACTA-1	diploid
TAACTTCAGTCCCAAT-1	diploid
GGAAGTGTCCATTCAT-1	aneuploid
GATTTCTCAGGGCTTC-1	aneuploid
TAATTCCTCACGGTCG-1	diploid
AACTTCTTCATCGCCT-1	aneuploid
ATTTACCCATGAATAG-1	aneuploid
ATTGGGTCAACAGCCC-1	aneuploid
CGGGTGTGTTGCTGAT-1	aneuploid
CACTGTCAGTGAATAC-1	aneuploid
GGCTTGGCAATGACCT-1	aneuploid
GTCGAATGTTCCATTT-1	aneuploid
ACTGTGAGTTCCACAA-1	aneuploid
ACCATTTCAACGGTAG-1	diploid
TCAGTTTCACCAGTAT-1	aneuploid
CTCAACCGTCTCACGG-1	aneuploid
TGCATCCAGTGGTGGT-1	aneuploid
GATTCTTTCCGATTAG-1	diploid
ATCGGCGCAGGTACGA-1	diploid
ATGAGTCGTGTTGATC-1	aneuploid
GGGATGAAGGAACTCG-1	diploid
CGAAGGAGTAAGATCA-1	diploid
TCATATCAGCCTGAAG-1	aneuploid
CTCTCGAAGTACTGTC-1	diploid
ATCGTAGTCCTACTGC-1	diploid
AACCTTTTCAGGGATG-1	aneuploid
GGTTAACCAGTCAGCC-1	aneuploid
GAACGTTTCGGACAAG-1	aneuploid
GGGTGAATCGGTCAGC-1	diploid
TGAACGTCATGTCAGT-1	diploid
TGGGCGTTCGGCATTA-1	aneuploid
AGAGCCCGTGACTATC-1	aneuploid
CAACGATCACTTTATC-1	aneuploid
CTTTCGGGTAAGATTG-1	aneuploid
TCGTCCAGTCGTACAT-1	aneuploid
CTAGACACAACGAGGT-1	aneuploid
TTGAGTGCATCTAGAC-1	aneuploid
ACGTAACGTCCAACGC-1	aneuploid
GCTACAATCCACGTAA-1	aneuploid
AGTACCATCCATCACC-1	aneuploid
AACGTCACAATTGAAG-1	aneuploid
AAGTGAAGTCCTTTGC-1	aneuploid
ACTGATGAGTCAGCCC-1	aneuploid
CTCTGGTCAACGACAG-1	aneuploid
TGCGACGAGCTGACAG-1	aneuploid
TCAGTCCTCGCCGTGA-1	aneuploid
CATCAAGTCCCAACTC-1	diploid
TCAATTCTCTGCGGCA-1	diploid
TACCTCGTCGGTCTGG-1	aneuploid
GGGTCACAGATAGCTA-1	diploid
CACTGTCGTCGTGCCA-1	diploid
CTGAATGAGAACCGCA-1	aneuploid
TAGACCACAGCGTACC-1	diploid
TGAATGCAGGAGGCAG-1	aneuploid
GGAATCTGTCGGTAAG-1	aneuploid
GTCGTTCGTTGGTAGG-1	aneuploid
GATGGAGAGAGAACCC-1	aneuploid
CTGATCCGTAAGTAGT-1	diploid
CGAGTTATCAAGTGTC-1	aneuploid
TAGGTTGCAAAGCTAA-1	aneuploid
CTGCGAGCATCTAGAC-1	aneuploid
TGAGCATTCTTCTGGC-1	aneuploid
TCCCATGCACCGTCGA-1	aneuploid
ACTTTCACAAGAGAGA-1	aneuploid
TCGCACTGTCCGGCAT-1	aneuploid
AGGTGTTAGTGCAGCA-1	aneuploid
ATACCGAGTAGGCTCC-1	aneuploid
TGGTACACACATCCCT-1	aneuploid
CATTGTTGTTGGCTAT-1	aneuploid
TTAGGCACATACTTTC-1	aneuploid
CAACGGCCACAAGCAG-1	aneuploid
TCATTCAGTGGAATGC-1	aneuploid
TTGTTGTCAGTCGCAC-1	diploid
TGAGACTGTTGAAGTA-1	diploid
AGGCATTGTCCAGCCA-1	aneuploid
AGGAATATCGAGTCCG-1	aneuploid
ACTGATGGTAACAGTA-1	diploid
GTGGGAAAGTTCTCTT-1	aneuploid
TGTAAGCGTCCTTTGC-1	diploid
TCAGTGATCCGAGTGC-1	diploid
AGGAGGTTCAAGTGGG-1	aneuploid
TTCCTTCCAACTGATC-1	aneuploid
ATTCAGGAGTCCTACA-1	diploid
TTCTTCCGTTACGGAG-1	diploid
ATGACCAAGCCGGATA-1	aneuploid
GAAGGACGTAGCGTAG-1	aneuploid
CGAGGCTTCTTGCAAG-1	aneuploid
TCATCCGGTAGGCTGA-1	diploid
CCGGTGAGTGGGTATG-1	aneuploid
AAGTTCGGTATCGCAT-1	aneuploid
GGGATCCCAACGGTAG-1	aneuploid
CATCGCTGTCCGGATC-1	aneuploid
ATGCATGAGTCATAGA-1	aneuploid
GAGACCCTCACTTGTT-1	aneuploid
ACACAGTAGAGTCTGG-1	aneuploid
ACCATTTAGAAGCGGG-1	aneuploid
AGTCATGCACGAGGTA-1	aneuploid
GGGCTCAGTGATTCTG-1	aneuploid
AGATGAATCAGCTTCC-1	aneuploid
CAACAACAGCTGGCCT-1	aneuploid
ACAGCCGGTCCCAAAT-1	aneuploid
TCATTGTAGAATACAC-1	aneuploid
TGTGGCGAGGTGCCAA-1	aneuploid
GTGATGTTCTCCGCAT-1	diploid
AACCATGGTCATGACT-1	aneuploid
GTTGTGATCTATTTCG-1	diploid
CCGGTAGGTTATGTGC-1	diploid
CTACCTGGTGTCACAT-1	diploid
CCACGTTTCGCTTAAG-1	aneuploid
TTATTGCTCGCTGCGA-1	aneuploid
GAACTGTTCGCGTTTC-1	aneuploid
GAATAGACAATGTCAC-1	diploid
TCATTACCAGCTTCCT-1	aneuploid
ACATGCACATATGGCT-1	aneuploid
GATTCGACAGAGAATT-1	aneuploid
GATAGCTGTGGCTCTG-1	aneuploid
TCTGCCAGTCAACCTA-1	aneuploid
GCCTGTTTCCGCACGA-1	aneuploid
CATTTCAAGTTGCTCA-1	diploid
CTGTCGTCATAACTCG-1	aneuploid
TCGCACTCAATGAGCG-1	aneuploid
TCAGTTTGTTCGGTAT-1	diploid
CTCAAGAGTTCCGTTC-1	diploid
ATGAGTCAGCCGTCGT-1	aneuploid
ATCCCTGGTTAGGCTT-1	aneuploid
CATGCGGAGCCTCGTG-1	diploid
CGTAAGTCAACCAATC-1	diploid
ATCAGGTTCACCCTGT-1	diploid
ATGACCATCCCATTTA-1	diploid
AAACGAAAGACGACGT-1	aneuploid
GCGTTTCCACGTCGGT-1	aneuploid
CATTGTTAGAGGTATT-1	diploid
CAACAACTCTCTCCGA-1	aneuploid
AGATGCTAGGTGCCAA-1	aneuploid
AGTACCAGTTCGAAGG-1	aneuploid
CTGAGCGCATCCAACA-1	diploid
TGGATCAAGGCTGTAG-1	diploid
ATCGCCTGTACGACAG-1	aneuploid
CTCCATGAGCCTCATA-1	diploid
AATTTCCTCCGTCACT-1	aneuploid
CTTCAATCACATCCCT-1	aneuploid
GACGCTGAGTATGAGT-1	aneuploid
TGGAGGAAGGGTCACA-1	aneuploid
TGTTACTAGATGACAT-1	aneuploid
TCCTGCACATGTCGTA-1	aneuploid
TCAGCCTGTTTGACAC-1	diploid
GGACGTCAGTTAGTGA-1	aneuploid
AGACTCACAAGACCGA-1	aneuploid
AAGCATCAGTACAGCG-1	aneuploid
CCACAAAGTACGCTAT-1	aneuploid
GTCTAGAGTAGTCACT-1	diploid
GGGATCCTCACCCTTG-1	aneuploid
CTCCCTCCACTTCAGA-1	diploid
TCCAGAACACGATTCA-1	diploid
CGTTGGGTCATGCCAA-1	aneuploid
CATCGTCAGGTTGGAC-1	aneuploid
CAGGCCATCTCAACCC-1	diploid
AACTTCTCAGGGACTA-1	aneuploid
TAGGTACGTTAAAGTG-1	aneuploid
GACATCAGTGTTCGTA-1	aneuploid
CAGATCAGTATAGCTC-1	diploid
GTTGTAGAGTAGGAAG-1	aneuploid
CATTGCCTCCATTGGA-1	aneuploid
ATCGCCTCAAACCGGA-1	aneuploid
TTTCATGAGAGCAACC-1	diploid
TCCTCGATCATTGCCC-1	diploid
TATCGCCAGTGATAAC-1	diploid
CCATCACTCCACCTGT-1	diploid
CTAACCCGTCCAAGAG-1	aneuploid
CTCACTGGTTTGGAAA-1	aneuploid
ACTTTCAAGCGTTAGG-1	diploid
TGTGCGGCACGATTCA-1	diploid
GGGACTCGTGGCTCTG-1	aneuploid
AACGTCAGTTCTCTAT-1	aneuploid
ACTGTCCGTAACACGG-1	aneuploid
AACCTTTGTTCAGGTT-1	aneuploid
ACAACCAGTTGCGTAT-1	aneuploid
GAACGTTGTCACTTAG-1	aneuploid
AAGTGAAGTTCCGTTC-1	aneuploid
CAGTGCGCATCGCCTT-1	aneuploid
TGACAGTGTAGCTTTG-1	aneuploid
ATTCCCGTCCCATTCG-1	aneuploid
TGGGATTAGACTCTAC-1	aneuploid
ATTCATCTCCGCTGTT-1	aneuploid
CCGTTCATCGTAGTCA-1	aneuploid
GCCCGAAGTGACTGTT-1	aneuploid
GCTTCACGTGTCCCTT-1	diploid
AAAGTGAAGAGTGGCT-1	diploid
CACGTGGAGACCTCCG-1	aneuploid
TCCACCAAGAATTCAG-1	aneuploid
ACATCCCTCATTTGCT-1	aneuploid
TTCGGTCTCACGATCA-1	aneuploid
AGGTTGTAGCGGTAAC-1	aneuploid
CGTTCTGCACAAGGTG-1	aneuploid
CTCAATTCACAAGCTT-1	aneuploid
TCAATCTGTGTCTTGA-1	diploid
TGGATCAAGCAACAAT-1	diploid
CCTCTCCGTGCGGATA-1	diploid
CCGATGGGTGAGCTCC-1	aneuploid
CTAACTTTCGAGTGAG-1	diploid
ACCCTTGAGACCCGCT-1	diploid
GGCTGTGGTTAGGGAC-1	aneuploid
TACGGGCCAAGGGTCA-1	diploid
CAGGGCTCATTGAGCT-1	aneuploid
ACATGCAGTACCCGAC-1	diploid
ACGATGTTCTACGGTA-1	aneuploid
TCAAGCACACGGCGTT-1	aneuploid
GCCCAGACATTCGATG-1	aneuploid
AAGAACATCTGCGGGT-1	diploid
GCCAGCATCCCGAACG-1	diploid
GTAGAAAAGTCCCAGC-1	aneuploid
TCGATTTCAGGACTAG-1	aneuploid
AGGGTTTCACGTGAGA-1	aneuploid
ATCGCCTAGGGATGTC-1	aneuploid
GTCTTTAAGGTGGCTA-1	aneuploid
CTCTCAGTCCATGAGT-1	diploid
AATCGTGGTCATCACA-1	aneuploid
TACGTCCAGGGCAGTT-1	aneuploid
TAGGTACTCGACGTCG-1	aneuploid
GAGACTTCATTGTCGA-1	diploid
GCGGATCAGACTCAAA-1	diploid
GCATCTCGTCCACACG-1	aneuploid
TAACACGGTCGCTGCA-1	diploid
TCCGAAATCGTCCATC-1	aneuploid
GTAGTACTCACAAGAA-1	aneuploid
CTAACTTTCCCATTCG-1	diploid
TTCTGTACAGCGTTTA-1	aneuploid
TCTGTCGAGTTGTAGA-1	diploid
CTGCATCAGGTCATTC-1	aneuploid
CCTATCGAGACTAAGT-1	aneuploid
CCAATTTGTTGCATTG-1	aneuploid
ATGGTTGAGCAGAAAG-1	aneuploid
CTGTCGTGTGCAACAG-1	aneuploid
ACCAACAGTACCCACG-1	aneuploid
TGGTTAGGTTCAGCTA-1	diploid
AAACGAACAATACCCA-1	aneuploid
CTTCTAAGTACAGAGC-1	diploid
GAAGGGTGTCGTCTCT-1	aneuploid
CCATCACGTATCAGCT-1	aneuploid
CATTCCGCAGCGACCT-1	aneuploid
TCACATTCAGGTACGA-1	aneuploid
AAGAACACAGCGTTGC-1	diploid
GTAGATCGTGAATAAC-1	diploid
GTTCGCTCAGTGGTGA-1	aneuploid
TCATGGATCCATTGCC-1	aneuploid
CATTTCATCTGACCCT-1	aneuploid
CCTCCAATCGCTCTAC-1	aneuploid
AGTACCAAGGACAACC-1	aneuploid
GTTCGCTCATTGAAGA-1	aneuploid
AATTCCTTCCCAATAG-1	diploid
TAGTGCATCTTTCCAA-1	aneuploid
GTCGCGAAGTGCAGCA-1	diploid
TCTACATTCTCCCAAC-1	diploid
CACTGAAAGCGTTACT-1	aneuploid
TTGAACGAGGACAACC-1	diploid
TCCTTCTCATATGGCT-1	aneuploid
GTAAGTCGTCTGTTAG-1	diploid
TGCCGAGCAAGGACAC-1	diploid
TGGGAAGGTAAGATAC-1	aneuploid
TTCAGGAAGCACCAGA-1	aneuploid
TCTATACTCTTCCACG-1	diploid
CGCCAGAAGGGTCACA-1	diploid
TTCTCTCTCTCGAACA-1	diploid
TCGCACTCAATCGTCA-1	diploid
CACCGTTCATCTCATT-1	diploid
CCTCCTCGTACTTGTG-1	aneuploid
GTTGTGACAGTACTAC-1	aneuploid
GGAAGTGTCTCCGTGT-1	aneuploid
ACGGGTCGTGGTCTGC-1	aneuploid
CACAGGCCAGCAGTCC-1	diploid
ATTATCCGTCCGGTGT-1	aneuploid
CCGGACAAGCAGAAAG-1	diploid
CACTGAAAGTCATACC-1	diploid
GAGTTTGTCCTGCCAT-1	aneuploid
GAACGTTGTAAGACCG-1	aneuploid
GAACTGTGTAGTCACT-1	aneuploid
GTGCGTGAGGGATCGT-1	diploid
AGCGATTCATCGCTCT-1	diploid
CTCTCGAGTACGAAAT-1	aneuploid
AAGAACAAGTCTCCTC-1	aneuploid
AGGGTCCCACAAGCCC-1	diploid
TGTTGAGCAGAAATTG-1	aneuploid
GTAATCGCACCAGCTG-1	diploid
TGAGTCACAACTCCCT-1	diploid
ATTTCTGTCCACTTTA-1	diploid
CTGTATTTCATTCTTG-1	aneuploid
GAGGCAAAGTAGTCTC-1	diploid
CCATAAGGTGTAGGAC-1	diploid
ATGACCACAAACGAGC-1	diploid
ACATGCAGTATCATGC-1	diploid
AGTACTGTCAATCAGC-1	aneuploid
ACCAAACGTTCGTAAC-1	aneuploid
TGAGACTAGTGCAGGT-1	aneuploid
AGTGACTCAAGATCCT-1	diploid
GTGCAGCCATCGAACT-1	diploid
TGCACGGTCAACTGGT-1	aneuploid
CGGGCATGTGTAGTGG-1	aneuploid
ACACAGTAGAGCCGAT-1	aneuploid
ATTTCACGTGACACAG-1	diploid
CTCTCAGCAAGTTCGT-1	diploid
TTCCTCTAGATGCAGC-1	diploid
TTTACTGAGGTAGATT-1	aneuploid
CGGGCATCAGACGATG-1	aneuploid
AATCGACCAAAGGCGT-1	diploid
AGGACGAAGCTCTGTA-1	aneuploid
GTAGGAGCACATAGCT-1	aneuploid
TCACAAGAGTGTACAA-1	aneuploid
TTCCGGTGTGAACGGT-1	diploid
CCGATCTAGGAAAGTG-1	aneuploid
AGTAGTCTCTGAGCAT-1	aneuploid
GAGAGGTTCCAAGAGG-1	diploid
TCGACGGCATGTGGCC-1	aneuploid
GAATAGAAGTTTCTTC-1	aneuploid
TCATTGTAGTACTCGT-1	aneuploid
CTTTCAAAGGATTCAA-1	aneuploid
GCACGTGCATAACCCA-1	diploid
GGTGTTATCTCGTGAA-1	aneuploid
TGGGATTTCAATCTCT-1	aneuploid
GGAGGATCAAGCGAAC-1	aneuploid
ACGGGTCTCAACTTTC-1	aneuploid
ATCGTAGGTCCTACGG-1	aneuploid
TGGCGTGCAGCGGTTC-1	aneuploid
CCTACGTTCGCGGTAC-1	aneuploid
CAGATCATCTGGCCTT-1	diploid
GAGCCTGCAATATCCG-1	aneuploid
CCACAAAAGCCGATCC-1	diploid
GCTGGGTCAGGCGTTC-1	aneuploid
GACAGCCTCGACACCG-1	aneuploid
AGTACTGCAAGCTCTA-1	aneuploid
CTTTCAATCTGGTTGA-1	aneuploid
GTATTGGTCGCAACAT-1	aneuploid
CTGAGCGGTACCTGTA-1	diploid
GGGAAGTGTTCCTAAG-1	diploid
ATGATCGCAGTCAACT-1	diploid
CACTGTCCAAGCGATG-1	diploid
CCGATGGAGCTAGAGC-1	aneuploid
TCCGGGATCGTTATCT-1	diploid
GACTCAATCCTTCACG-1	aneuploid
CCCTGATGTTTACTTC-1	aneuploid
CGGGACTGTGACATCT-1	diploid
AGAAGCGAGGAACTCG-1	diploid
TGAGCGCTCACCCTCA-1	aneuploid
TTCCACGAGCAGATAT-1	diploid
TCAAGCAAGAATCCCT-1	diploid
AGTGCCGCATGGCGCT-1	diploid
GAGCCTGAGGAATTAC-1	diploid
GTAGGAGAGTTGCTGT-1	diploid
ACTTTGTAGTATTCCG-1	aneuploid
AGACCATGTGTGAGCA-1	diploid
TACACCCCACGAGAAC-1	aneuploid
GTGTGATTCCGGTAAT-1	aneuploid
ATGAGGGTCCTGGCTT-1	aneuploid
TATTCCATCATGGATC-1	aneuploid
CATTGTTCAGAATGTA-1	aneuploid
ATTCAGGAGGGTAATT-1	aneuploid
GTACAGTGTGACGTCC-1	aneuploid
TCGGGCAGTATGGTTC-1	aneuploid
CTGGCAGTCCTCACGT-1	aneuploid
TTCCGTGCATTGCCGG-1	diploid
GGGTAGAGTACAGAGC-1	aneuploid
AGAAGTACAGCGTGCT-1	aneuploid
CTCATTACACACCGAC-1	aneuploid
TGCTTGCCAGTCTGGC-1	diploid
AGAAGTAAGGCCTTCG-1	diploid
TCAGCCTGTAGAATAC-1	diploid
ATGACCATCGCATTAG-1	aneuploid
GATGATCCATAACCCA-1	aneuploid
ACAGGGAAGTGCACTT-1	aneuploid
CAGTTCCTCGCTCTAC-1	aneuploid
CGGGTCAGTTAAGGGC-1	diploid
GTCATTTCACTACTTT-1	diploid
ACTGCAATCGTGGAAG-1	aneuploid
ATGTCTTAGTGGTTAA-1	aneuploid
TGCACGGCAAAGTGTA-1	aneuploid
GTCTTTAAGTATGATG-1	aneuploid
AGAAATGGTATGGGAC-1	diploid
TAAGCACGTGCTCCGA-1	diploid
AAAGGTACAGCTACAT-1	aneuploid
AGTTCGAAGATGAAGG-1	aneuploid
ACAGCCGAGATAGCTA-1	diploid
CGGTCAGTCTACACTT-1	aneuploid
GCATCTCAGGTAAACT-1	diploid
CTTTCAAGTAGCGATG-1	diploid
ATCGGATAGGTTACCT-1	diploid
TATTTCGCAGCTTCCT-1	aneuploid
TGTAAGCAGAATTGTG-1	aneuploid
CTCTCAGGTTGCCAAT-1	diploid
ACGGTTACACGTTGGC-1	diploid
CTGCCTAAGGTAGTCG-1	diploid
GTAGAAAAGTTGCTCA-1	aneuploid
CAGCCAGCACAGACGA-1	aneuploid
ACAGCCGAGCGATGCA-1	aneuploid
TGGGAAGAGTCATACC-1	aneuploid
AGAGCAGAGGATATGT-1	aneuploid
GGTGGCTTCAACTACG-1	diploid
CTGGCAGCAGTTTGGT-1	aneuploid
TGTGAGTGTGCGTGCT-1	diploid
TCTGGCTAGGCGCTTC-1	diploid
TAAGCACAGCCACTCG-1	aneuploid
ACACAGTCAGTTAGAA-1	aneuploid
AGATGCTTCATTGTGG-1	aneuploid
ACCACAAAGACATATG-1	aneuploid
ACGGTTATCTATACGG-1	aneuploid
TGGATCACATTCCTAT-1	aneuploid
AAGTTCGAGGCCTGCT-1	diploid
TCACTATAGGTCCCGT-1	aneuploid
TCAGTCCTCTACGCGG-1	aneuploid
TCCCATGAGTACCATC-1	aneuploid
GCATGATTCGGTGTTA-1	aneuploid
GATCATGGTACACGTT-1	aneuploid
TGCGGGTGTGTTAGCT-1	aneuploid
AGTCAACCAGAACTCT-1	aneuploid
CGTTAGAAGACTCAAA-1	aneuploid
CTACCTGGTGACATCT-1	diploid
TCATGGATCCTACACC-1	aneuploid
TTGTTGTAGCCTATCA-1	aneuploid
CATCGGGAGTTGTAGA-1	aneuploid
ATTTCTGGTGATACTC-1	aneuploid
GGTAATCAGTGATAGT-1	diploid
TGAGACTTCGATGCTA-1	diploid
TCGCACTAGGAACGTC-1	diploid
TACAGGTTCCGTCAAA-1	diploid
TACAACGCACGCTATA-1	diploid
CACACAAAGATACTGA-1	diploid
GCCTGTTTCACTTGTT-1	diploid
CATGAGTAGTTGTACC-1	aneuploid
TACGCTCAGGCCACTC-1	aneuploid
ACTTTCAAGCCATTCA-1	diploid
GTCGTTCCAGGTGTTT-1	diploid
TTTGGAGTCTCGACGG-1	aneuploid
TTAGGCATCGGCAGTC-1	diploid
CAACAGTAGTCGAAAT-1	diploid
ATGAGGGAGGCCTGCT-1	aneuploid
CATGGATTCGCGTAGC-1	diploid
TGGGCGTTCCGAGCTG-1	aneuploid
GGCAGTCAGAAGGCTC-1	diploid
GGGAGATTCATGGCCG-1	aneuploid
AAAGGGCAGTTCCGGC-1	aneuploid
GAGACTTCATCCGGCA-1	diploid
AATCGTGAGTCAGGGT-1	aneuploid
AATCGACGTCCGGACT-1	aneuploid
CTCCACACACATACGT-1	diploid
TAGGAGGGTGGTCAAG-1	aneuploid
AAGGAATAGGATAATC-1	diploid
GACACGCGTGCTTCAA-1	aneuploid
GCTGAATCATTGACAC-1	aneuploid
TAGTGCACACGTCGGT-1	aneuploid
TCAAGACTCTACTCAT-1	aneuploid
CATCCCAGTATCGAGG-1	diploid
CATTCCGTCTAGGCAT-1	aneuploid
TACAGGTAGGAGATAG-1	diploid
GTCCTCATCAAGAAAC-1	diploid
CATCCGTAGGCCCAAA-1	aneuploid
GGGAGTACATACCATG-1	aneuploid
CGAATTGAGAAGCTGC-1	aneuploid
AAGCGAGGTAGTTAGA-1	aneuploid
CGTTGGGAGGAGGCAG-1	aneuploid
TGCATGACACAAGTTC-1	aneuploid
GTCCTCAGTAAGATAC-1	diploid
ATCGCCTCATGGGATG-1	aneuploid
ACGTAACTCAGCGGAA-1	diploid
CCTCTCCAGAGTCCGA-1	aneuploid
AAGCGAGTCCGTGCGA-1	diploid
GAGCCTGCAGCTGTCG-1	aneuploid
CTTTCGGAGATCGCTT-1	aneuploid
CTCCGATAGAGGTATT-1	aneuploid
GTGTTCCCATTGCCGG-1	aneuploid
AACCAACAGCGTTAGG-1	aneuploid
TTAGGGTGTGCCTGAC-1	aneuploid
ACAAAGACACGGTAGA-1	aneuploid
GTAATGCTCATGAGTC-1	diploid
GTCATTTTCACTACTT-1	aneuploid
GAGCTGCTCGGTCTAA-1	aneuploid
ATTATCCGTTATCTGG-1	aneuploid
CTGAGGCGTACTAGCT-1	aneuploid
CATACAGAGATTGAGT-1	aneuploid
GGGTATTAGCGTCGAA-1	aneuploid
TTTATGCGTGCGGATA-1	aneuploid
AATCACGAGTTCGGTT-1	aneuploid
GACCGTGTCTGCGGAC-1	aneuploid
TAGCACACACTGGATT-1	aneuploid
GAAGGGTCAACCTAAC-1	aneuploid
CACTGGGGTGTCCTAA-1	aneuploid
CTCCTTTTCCATATGG-1	diploid
GTGTAACTCTTCACGC-1	aneuploid
AGGATAAAGGATCACG-1	aneuploid
GCCCGAACATTACTCT-1	aneuploid
TGATTTCTCACCCATC-1	aneuploid
GCGGAAATCTTAATCC-1	aneuploid
TTGTTTGGTTCCACGG-1	aneuploid
TTGGGTATCGTGGCTG-1	diploid
TCGTAGATCGAACCTA-1	aneuploid
CGAATTGAGTCATTGC-1	diploid
ATCACTTAGGTTAAAC-1	aneuploid
TATCTTGTCATGAAAG-1	aneuploid
TACTTGTTCAGACTGT-1	aneuploid
CATCGTCTCTTTCCGG-1	aneuploid
AGACCATTCTGTTGGA-1	aneuploid
GAATAGACATCGATGT-1	diploid
ACTGATGTCTGATGGT-1	diploid
ATCGTGACAATTCTTC-1	aneuploid
CCCGGAACAGAACCGA-1	aneuploid
GGCTTGGTCAATCCAG-1	diploid
TTACGCCAGGTGATAT-1	aneuploid
AACCAACCAGAACTTC-1	aneuploid
TGCTTGCTCTACCAGA-1	diploid
TCGTCCAGTGGCTAGA-1	aneuploid
TCCTCGAAGTAAACGT-1	aneuploid
AGGTTGTAGAACAGGA-1	aneuploid
TCGCTCAGTCCAACGC-1	aneuploid
GCCAGTGAGCTGGAGT-1	diploid
TGGGAAGGTCGATTCA-1	aneuploid
GAGCCTGCAGGGTCTC-1	diploid
TGTGGCGTCCATCTAT-1	diploid
CCGCAAGGTACAAAGT-1	aneuploid
CCCAACTGTTTACTGG-1	aneuploid
AGACAGGCACAAATAG-1	aneuploid
GTTGCTCGTACGGATG-1	diploid
TTACGCCTCAGGTAAA-1	aneuploid
ACCAAACGTTGATCGT-1	diploid
GAACTGTAGGTACTGG-1	aneuploid
TTCATTGAGAACTCCT-1	aneuploid
TCTTAGTTCGTGCGAC-1	aneuploid
CACTGTCTCCAAACCA-1	aneuploid
CTGCTCATCTGCGGGT-1	diploid
GGGAGTAGTAGGGAGG-1	aneuploid
TTGCCTGAGCTGCCTG-1	diploid
TACACCCTCAGCAATC-1	diploid
AGAAATGAGCAGAAAG-1	aneuploid
TCTGTCGGTGTCCGGT-1	aneuploid
AATGGAATCATTCGTT-1	aneuploid
TTCAGGACACTCCGGA-1	aneuploid
GACCAATTCCGATCTC-1	aneuploid
GTAACACTCATTTGTC-1	aneuploid
TGGGAAGAGGACATCG-1	aneuploid
CATTGAGCAGGGTCTC-1	aneuploid
CAATCGAGTGTTATCG-1	aneuploid
GAGTGAGCAGTTGCGC-1	aneuploid
TCTTTGACAGGATTCT-1	aneuploid
CAGCACGTCAGTGTGT-1	aneuploid
ATACCTTTCAGGACGA-1	aneuploid
AGTGCCGAGGGATCGT-1	aneuploid
ATCGTCCCAGTCTCTC-1	aneuploid
GGGAGTAAGGCTTTCA-1	diploid
TCATCCGCAGAGGCAT-1	aneuploid
CTTGAGATCTAAACGC-1	diploid
GTCACTCCAATAGTGA-1	aneuploid
CAAGGGAGTTCACGAT-1	aneuploid
CAGTGCGTCAAGTCGT-1	aneuploid
CCAATGAGTTGTGGAG-1	aneuploid
ACTTATCAGGTCATAA-1	diploid
AAGGTAAAGTGCCAGA-1	diploid
GTGCACGGTCCTACAA-1	diploid
TCAGCAAGTGACTAAA-1	aneuploid
AGACCCGGTACCGTCG-1	aneuploid
TCGCTTGGTTACGTAC-1	diploid
GAGGCCTGTCCTGGGT-1	aneuploid
CGCCAGATCCAGCTCT-1	aneuploid
GTAATCGCAGTCTGGC-1	aneuploid
CTCCCTCGTAGGGAGG-1	aneuploid
CCTCAACAGGGTACGT-1	diploid
CATCAAGAGTGGTGAC-1	diploid
CCTGCATAGAGGTCAC-1	aneuploid
CAACGGCTCCGCAGTG-1	aneuploid
TCTGGCTAGAGGTTTA-1	aneuploid
GAGACCCGTATTTCCT-1	aneuploid
CGACAGCAGCTACTAC-1	aneuploid
CCGGACAGTCCTTTGC-1	aneuploid
AGTCTCCCAGTAGAGC-1	diploid
TCACATTCAAGGTACG-1	aneuploid
CTCTGGTTCTCAGAAC-1	diploid
TCCTTTCAGTATGAAC-1	aneuploid
AACCATGTCATCCTAT-1	aneuploid
TGCTTCGAGGAAAGAC-1	aneuploid
GGGAAGTTCTCTTAAC-1	aneuploid
GACCGTGGTACGGTTT-1	aneuploid
TTCACCGTCAGGAGAC-1	aneuploid
GTGTCCTGTAACGGTG-1	aneuploid
GAAGGGTAGTAGAGTT-1	diploid
TTGGGTAAGTCTTGGT-1	aneuploid
TGGATGTAGTGGTTAA-1	aneuploid
GAGAAATCATCAGTGT-1	diploid
ATCGTAGTCGACGATT-1	diploid
TTACCGCCACCGTGCA-1	diploid
TTGGGCGGTTAGTCGT-1	aneuploid
TTTCGATGTACTTGTG-1	aneuploid
TTTGTTGGTGCGTCGT-1	aneuploid
GACCCTTCATACTGTG-1	aneuploid
ACAAGCTAGGGCTAAC-1	aneuploid
GAGTCATCACCCATAA-1	aneuploid
CAGATCACAGTATTCG-1	aneuploid
TCGTGGGGTCTAGTGT-1	aneuploid
TGCTCGTAGTTCACTG-1	aneuploid
CGAATTGAGGCCTAAG-1	aneuploid
TCCTGCACAGTTCCAA-1	diploid
TGTTCTAGTCCGATCG-1	diploid
AAGTCGTAGAGAGGGC-1	aneuploid
GAAGCGAAGGGAGATA-1	aneuploid
GCATCGGTCCACAGCG-1	aneuploid
GCGTGCATCCAATCCC-1	diploid
GCCGTGAAGATTAGTG-1	aneuploid
CGTAGTATCCTACCGT-1	diploid
GAGTTGTGTTCTCTCG-1	aneuploid
TTCCTTCGTTTCTATC-1	aneuploid
GTGGCGTAGTTCATCG-1	aneuploid
CGAGTGCTCAGACCTA-1	aneuploid
ATTCGTTGTAGCGCCT-1	aneuploid
TTCGGTCGTTGCGGAA-1	aneuploid
GTAAGTCAGTGAATAC-1	aneuploid
GTGTAACCATAAGCGG-1	diploid
CTGCCTATCAAACGTC-1	diploid
CGACAGCAGGTAAGAG-1	diploid
TGCAGGCTCCGCAGTG-1	aneuploid
GCTTCACCAGATACCT-1	diploid
TCCTCGAGTGGGTCAA-1	aneuploid
GAACTGTAGTTACGTC-1	aneuploid
GGGACAACAGCGTTGC-1	aneuploid
CTGTAGAGTGCCTGCA-1	aneuploid
CTACAGAGTTCTATCT-1	aneuploid
GTGTGATCAAATGGAT-1	aneuploid
ATTCGTTAGTCGGCAA-1	aneuploid
AACGTCACAGTTTCAG-1	aneuploid
ATGAAAGAGGTTATAG-1	aneuploid
GTCAGCGCAAAGCTCT-1	aneuploid
GCATCTCGTTGCCAAT-1	aneuploid
CACATGACAGTGAGCA-1	aneuploid
TGCATGAAGTCATGAA-1	aneuploid
CGTGTCTGTAGATTAG-1	aneuploid
AGATGAATCGGACTTA-1	diploid
AGAGCAGAGTGGTTAA-1	aneuploid
ATGTCTTCAAGTTCGT-1	diploid
CGTGAATAGAGTGGCT-1	aneuploid
GAATAGAGTGACTGTT-1	aneuploid
CGATGCGAGCCTTTCC-1	aneuploid
ATCGGATTCGGTCATA-1	aneuploid
ACTATGGCAGCATACT-1	diploid
GCCATTCGTCGGTGTC-1	aneuploid
CAGCCAGTCTCTCCGA-1	diploid
ACAGGGAAGTTGAAGT-1	diploid
CGGGCATTCGTAGGAG-1	diploid
TACCCGTCATCCAATG-1	aneuploid
GTCGTAACAGCGTACC-1	aneuploid
CATACAGGTACTCGTA-1	aneuploid
ATCATTCAGATCGACG-1	aneuploid
AAGCATCGTGTCTTCC-1	aneuploid
ACACGCGGTGGATACG-1	aneuploid
GCTTGGGTCTTTGCTA-1	aneuploid
GGTTAACTCGAGCCAC-1	aneuploid
AAAGGATTCGTAACAC-1	aneuploid
GAACACTGTCAAGGCA-1	diploid
TAACCAGAGATCCCGC-1	diploid
TAATTCCGTCTCTCCA-1	aneuploid
GAGATGGCATGCCGGT-1	aneuploid
GTCATCCAGTAGTGCG-1	diploid
CTGTGGGAGTCCCAGC-1	aneuploid
GAACTGTAGTCAAGCG-1	diploid
GGGAGTATCCTAACAG-1	aneuploid
TACCTGCTCGAGAATA-1	aneuploid
ATCTCTATCATTCACT-1	diploid
GGCTTGGGTCTTCTAT-1	diploid
ATTTACCAGGATAATC-1	diploid
GTGAGTTGTCATAAAG-1	aneuploid
CTTCAATTCATTTCGT-1	aneuploid
GTATTGGCACCGCTAG-1	diploid
AGACCATCAGCGATTT-1	aneuploid
AGGCCACTCGTTGTGA-1	aneuploid
TCGGGACGTGCTGATT-1	diploid
AGAAGTAGTATAGGAT-1	aneuploid
GATCACACAATTTCGG-1	diploid
TGACTCCCATACCAGT-1	aneuploid
TTTGGTTAGTATTCCG-1	aneuploid
ACCTGTCGTGGGCTCT-1	aneuploid
GGAGCAAGTCCCTCAT-1	diploid
GATTCTTCATAGCACT-1	aneuploid
CCTTTGGGTAACATCC-1	diploid
GGTGTCGTCGTGGGAA-1	aneuploid
ATTTCACTCTGGTTGA-1	diploid
TTTGTTGTCCAAGCCG-1	aneuploid
GATGTTGCACGGTGAA-1	diploid
TAAGCGTAGTCGGCCT-1	aneuploid
TCTACCGTCGCATTGA-1	aneuploid
CCATCACGTAGAGACC-1	aneuploid
ACCTGTCGTTCAAACC-1	aneuploid
CCCGGAAGTGGTCCCA-1	aneuploid
TCCTCCCGTGTAAACA-1	aneuploid
TTCGCTGCACACCTTC-1	aneuploid
GGCTTGGTCACCTTAT-1	aneuploid
GGGCGTTTCGGCTATA-1	diploid
GATGTTGAGACAGCTG-1	aneuploid
AGGACGACAACTGCTA-1	diploid
GAGCCTGGTCTAGATC-1	diploid
AACTTCTTCATGAGGG-1	aneuploid
CCCTCTCAGAATTGCA-1	aneuploid
GTAGAAAGTCCCGGTA-1	aneuploid
ACTTCGCAGGAGTCTG-1	aneuploid
CAACAGTGTGAGATTA-1	diploid
TAGTGCAGTTTGAACC-1	aneuploid
CAATCGATCGCATTGA-1	aneuploid
GAAGCGACAATCAGCT-1	diploid
GAAGCGAGTGGCCACT-1	aneuploid
CGTTCTGAGTGCACCC-1	aneuploid
TCTCTGGTCCGAGTGC-1	aneuploid
GGCAGTCTCCCGATCT-1	diploid
GATCAGTAGAGGCTGT-1	diploid
CGAGTGCGTGGTATGG-1	aneuploid
AGACAAAAGTTTCTTC-1	aneuploid
CTCAGAAAGGCTAGCA-1	aneuploid
AGCGCCATCCGTCCTA-1	aneuploid
ATTCAGGGTCCGACGT-1	diploid
GAGTTTGCACCAAAGG-1	diploid
ACTATTCGTAAGGAGA-1	diploid
TATGTTCCACTGAGGA-1	aneuploid
GATGAGGAGTCAACAA-1	diploid
CGAGGCTAGCACGTCC-1	aneuploid
CGCAGGTCACCAGCCA-1	aneuploid
TCATTCACAGGCGATA-1	aneuploid
TTTACCAGTTTGACAC-1	aneuploid
TGTTCATAGGCTAACG-1	aneuploid
GGCTGTGCAAGGACAC-1	aneuploid
TGCCGAGGTATCTCTT-1	aneuploid
GCCAGCAGTCGTTGGC-1	aneuploid
TCCTGCAAGCAGGCTA-1	aneuploid
TTCGGTCCACAAACGG-1	aneuploid
CTAGACAGTACCCACG-1	aneuploid
CGCCATTGTGCTGTCG-1	aneuploid
AACCCAATCAAGTCTG-1	diploid
GTCATGAGTAGGCTCC-1	diploid
TCCTCCCGTCCAACGC-1	aneuploid
TACATTCAGAGTCTGG-1	aneuploid
ATGGATCTCATGAGTC-1	diploid
AAGATAGAGCATACTC-1	aneuploid
TGGATCACAGGATGAC-1	diploid
GACTCTCCAATCGCAT-1	diploid
ACCCAAATCTGAGAAA-1	aneuploid
TGTTCCGAGAAACTGT-1	aneuploid
ATGGGTTTCGTCCTTG-1	diploid
AATGGAATCTATCCAT-1	diploid
GCGAGAATCCAGTACA-1	diploid
GTATTTCTCCGGCTTT-1	aneuploid
GGTAACTTCTGCCTGT-1	aneuploid
TTGAGTGAGTGTAGTA-1	aneuploid
GAGTCTAGTCCAGGTC-1	diploid
CTCATTAAGCACTAGG-1	aneuploid
CGAATTGGTTGGATCT-1	diploid
AGGAGGTGTCATGGCC-1	aneuploid
GATCACAAGATCACCT-1	aneuploid
ATTGGGTCAGTTTCAG-1	diploid
TAAGTCGTCTCTATAC-1	diploid
TTCAGGAGTCATGGCC-1	diploid
CGCCATTTCAACTACG-1	aneuploid
TCGCAGGAGCTGCCTG-1	diploid
CTCAGGGGTGCGTTTA-1	diploid
GATTCGAGTACGCGTC-1	aneuploid
TACCGAAAGGGACAGG-1	aneuploid
TCGTGGGTCATTTACC-1	diploid
TCCCACACAGGTAGTG-1	diploid
TAAGTCGGTGTCTAAC-1	diploid
GATTGGTAGGAACTAT-1	diploid
GACTATGCAAGTGCAG-1	diploid
GGGTCTGCATACCGTA-1	aneuploid
CATGCAATCATTCCTA-1	aneuploid
CTGGTCTGTGCTATTG-1	aneuploid
TTTACCAAGACTTGTC-1	aneuploid
GGCTTTCAGGTTGGAC-1	aneuploid
GGTGTCGGTGTCCGGT-1	diploid
AGCGTCGCAGAGTCAG-1	aneuploid
GCACTAAAGACGTCGA-1	diploid
AGGGTGAAGCAGGGAG-1	aneuploid
TATACCTAGCAGGCAT-1	diploid
ATGTCTTAGCGTGTTT-1	diploid
CTGCATCAGCGTACAG-1	diploid
ATCGATGCAGGCACAA-1	aneuploid
AGTGATCGTTGATCGT-1	aneuploid
GGTTAACTCTATCGGA-1	aneuploid
ACTATCTAGCCAAGGT-1	diploid
GTCTGTCAGACACACG-1	aneuploid
GGCTTTCCAAGCACCC-1	aneuploid
TCTACATTCGTGGGTC-1	aneuploid
AAGCCATGTCGGTGAA-1	diploid
CTAACCCGTGATAGAT-1	diploid
ATTATCCGTAGTGTGG-1	aneuploid
AAGAACAAGTTACGAA-1	aneuploid
CCGAACGAGACGGAAA-1	aneuploid
GAAACCTCAGAACGCA-1	aneuploid
GGCTGTGAGGTTCTAC-1	aneuploid
GCAACATAGCCACCGT-1	diploid
ATATCCTGTCTTGAGT-1	diploid
CAGCCAGTCTCTCGAC-1	aneuploid
CCTATCGGTTACACAC-1	aneuploid
TCGCTTGTCGTAGTCA-1	aneuploid
CTCCACAAGACTTAAG-1	diploid
TCCTCTTGTGTATCCA-1	aneuploid
ACTCCCAAGCTGGAGT-1	aneuploid
CAGTTCCTCTAGGAAA-1	aneuploid
CTAACCCTCAGAGCGA-1	aneuploid
CGGAGAATCTTCTTCC-1	aneuploid
CGGGACTCATGTAACC-1	diploid
TAAGTCGGTTGCTCGG-1	diploid
TCCGATCAGTCTTCCC-1	aneuploid
TTTGGTTCACCTAAAC-1	aneuploid
TGCATGATCGGTCTGG-1	aneuploid
GCTACCTAGCGACAGT-1	aneuploid
TGCTCCAGTCACTCTC-1	aneuploid
GCGGATCAGACAGCTG-1	aneuploid
CACTAAGGTCCGGTCA-1	aneuploid
ACTCTCGGTTCGGTAT-1	aneuploid
CATGCGGGTCATCAGT-1	aneuploid
TATTGCTGTGTAGTGG-1	aneuploid
CTGAGGCAGTGGCCTC-1	aneuploid
CCACTTGAGTCTCGTA-1	diploid
GATGTTGGTTCAGGTT-1	aneuploid
TCGCACTTCTACGCGG-1	aneuploid
CATCCCAAGTTGGGAC-1	aneuploid
ATCGTAGTCGGCCAAC-1	aneuploid
AGACCATCACGCTGTG-1	diploid
AAGTCGTTCACGTAGT-1	aneuploid
ATGGGAGTCAACGTGT-1	diploid
GGCAGTCCAGCTTTCC-1	aneuploid
CCAATTTCAATGTCAC-1	diploid
ATGCCTCGTGAATGTA-1	aneuploid
GTCATGACAGCTTCGG-1	diploid
GACTCAAAGAGTCTGG-1	diploid
TTTAGTCCATGACTTG-1	diploid
TAGGGTTGTCCAAGAG-1	aneuploid
TGTCCCATCACGAGGA-1	aneuploid
TGAATCGAGGTATTGA-1	diploid
CCTGTTGAGACAGCTG-1	diploid
GGTTAACAGGTTACCT-1	diploid
TGTTACTGTTGCGAAG-1	aneuploid
GACCCAGTCGGTCGAC-1	diploid
GAATAGAAGCGCTGCT-1	diploid
GCCATGGCAGTCGGAA-1	aneuploid
CTACCTGAGTCATGAA-1	aneuploid
CATGAGTAGGATTTCC-1	aneuploid
CATTTCAGTTGTATGC-1	diploid
TGACGCGAGTTCCATG-1	diploid
TCAGTTTAGTACTGTC-1	aneuploid
TGTTTGTAGATAGGGA-1	diploid
GAATCACCAAGCACAG-1	aneuploid
AACCTTTGTCGCATGC-1	diploid
TACCCGTTCCCGTAAA-1	aneuploid
GGTCTGGCACAACCGC-1	diploid
ACTACGATCCGCACTT-1	aneuploid
AGCGTATTCTAGCATG-1	diploid
CCTCAGTCATCCCGTT-1	aneuploid
AAGATAGGTAGACGGT-1	aneuploid
GAGATGGGTTCCTACC-1	aneuploid
TCATACTGTCTGTGGC-1	diploid
AGCCACGAGTTACGAA-1	aneuploid
TTCTTCCGTTCGGACC-1	aneuploid
GAGCCTGCATACTGTG-1	aneuploid
GGCTGTGTCTCAGTCC-1	aneuploid
GGGATGATCACCTTAT-1	diploid
AGGTCATCAGTGTATC-1	diploid
CGCCAGATCCTAAGTG-1	diploid
ACCACAATCGGTCTAA-1	diploid
CTGGCAGCATCTAGAC-1	aneuploid
GAGTTGTCAATAACGA-1	aneuploid
TCGGGTGAGCGCATCC-1	aneuploid
TACGGGCAGTCTGTAC-1	aneuploid
TCAAGTGGTCGCTTAA-1	diploid
CTTGATTAGTGTTGTC-1	diploid
AATTTCCTCGTCTACC-1	aneuploid
CCCGAAGAGCTTTGTG-1	aneuploid
AAACCCATCCCGAGAC-1	aneuploid
AAGAACATCCAGTTCC-1	diploid
GTCGCGATCAAGAATG-1	aneuploid
CTTTCGGGTGTGTGTT-1	diploid
TGCTTGCGTCCGGATC-1	aneuploid
CTGAGCGAGTGATAGT-1	diploid
TGCTCGTTCACCTGGG-1	aneuploid
TAGGGTTAGGTTCCGC-1	diploid
TTACGCCTCAAGCCTA-1	aneuploid
CCATAAGGTGGAAGTC-1	aneuploid
AACCTTTGTGCCGTTG-1	aneuploid
GCAGTTACATGAAGCG-1	diploid
CAGGGCTGTATGGGAC-1	diploid
CCACGTTCAGTGTGCC-1	aneuploid
GTCAAGTCACAGCGCT-1	diploid
GGGATCCTCCTCTCTT-1	aneuploid
CCTAACCGTTGTCAGT-1	aneuploid
TGAATCGGTTGGGATG-1	diploid
TAACTTCGTGTTAAAG-1	diploid
CTCCCAAAGGTTGGTG-1	aneuploid
GTAGTACGTGAGGATC-1	aneuploid
TGCATGACACTTTATC-1	diploid
GGGTTTAGTGTTAACC-1	aneuploid
AGACACTCAGCTCGGT-1	aneuploid
CAATCGAGTACTAAGA-1	diploid
CATCCCAGTAGCGATG-1	diploid
GCTACAATCGTTGTGA-1	aneuploid
TCGAACAGTAAGATTG-1	aneuploid
CACAACAGTACAGTTC-1	diploid
CCACCATAGCTTTCCC-1	diploid
GGAGATGCAGCAGTCC-1	diploid
GACCCAGAGTCTACCA-1	not.defined
CGGCAGTCACCAGCTG-1	not.defined
CCGATGGAGAGGGTGG-1	not.defined
ATGGATCAGAAGGATG-1	not.defined
GCCATGGCAGTTCTAG-1	not.defined
TTGGGATAGTCCTGCG-1	not.defined
CTAGGTAGTCTTTCAT-1	not.defined
TTCTGTACAGCAGTTT-1	not.defined
ACGATGTGTGATTGGG-1	not.defined
TCTTAGTGTCCAGCAC-1	not.defined
AAGACAAGTTGCACGC-1	not.defined
TGGTGATGTGGTAATA-1	not.defined
TGTTCATCACACCGAC-1	not.defined
GCATTAGAGTTAGTGA-1	not.defined
ACCCTTGCAATAAGGT-1	not.defined
GTCTCACCATGCCATA-1	not.defined
GTGGAGACATCCGGCA-1	not.defined
GTCACGGGTTCGGGTC-1	not.defined
TCACATTTCGTAGCCG-1	not.defined
TAGCACAAGTACAACA-1	not.defined
CCGTGAGAGGAGCTGT-1	not.defined
